The application has a rich set of screens organized by different user roles and functionalities. Here's the breakdown:

Authentication & Onboarding:
TourScreen - Initial onboarding screen
LoginScreen - User login
RegisterScreen - User registration
Dashboard Screens (Role-based):
DashboardScreen - Main dashboard for operators
AdminDashboardScreen - Dashboard for administrators
SuperAdminDashboardScreen - Dashboard for super admins
SystemOwnerDashboardScreen - Dashboard for system owners
Vehicle Management:
VehicleListScreen - List of vehicles
VehicleProfileScreen - Vehicle details
AddVehicleScreen - Add new vehicle
EditVehicleScreen - Edit vehicle details
VehicleCategoriesScreen - Vehicle categories management
VehicleTypesScreen - Vehicle types management
VehicleComponentsScreen - Vehicle components management
AdminVehiclesListScreen - Admin view of vehicles
AdminVehicleProfileScreen - Admin view of vehicle details
Checklist Management:
ChecklistScreen - Pre-shift checklist
AllChecklistScreen - All checklists view
CheckDetailScreen - Checklist details
QuestionaryChecklistScreen - Questionary checklist
QuestionarySelectionScreen - Questionary selection
QuestionaryChecklistItemScreen - Questionary items
ChecklistCategoriesScreen - Checklist categories
QuestionaryChecklistItemCategoryScreen - Questionary categories
QuestionaryChecklistItemSubcategoryScreen - Questionary subcategories
Incident & Safety:
IncidentReportScreen - Report incidents
IncidentListScreen - List of incidents
IncidentDetailScreen - Incident details
SafetyAlertsScreen - Safety alerts
PerformanceReportScreen - Performance reporting
User Management:
ProfileScreen - User profile
UserManagementScreen - User management
OperatorsListScreen - List of operators
CicoHistoryScreen - Check-in/Check-out history
Certification Management:
CertificationsScreen - List of certifications
CertificationDetailScreen - Certification details
CertificationScreen - Create/Edit certification
System Management:
SystemSettingsScreen - System settings
BusinessManagementScreen - Business management
SitesScreen - Sites management
TimeZonesScreen - Timezone management
CountriesScreen - Country management
EnergySourcesScreen - Energy sources management
Group Management:
GroupManagementScreen - Group management
GroupRoleManagementScreen - Group role management
Other Features:
QRScannerScreen - QR code scanner
NotificationScreen - Notifications
CountriesScreen - Country management


